[
  {"x": 2,        "y": 1},
  {"x": 2,        "y": 2},
  {"x": 2,        "y": 3},
  {"x": 2,        "y": 4},
  {"x": 2,        "y": 5},
  {"x": 3,        "y": 5},
  {"x": 4,        "y": 5},
  {"x": 5,        "y": 5},
  {"x": 6,        "y": 5},
  {"x": 7,        "y": 5},
  {"x": 8,        "y": 5},
  {"x": 9,        "y": 5},
  {"x": 10,        "y": 5},
  {"x": 2,        "y": 5},
  {"x": 2,        "y": 6}
]
